##################
#.R__............#
#....#######.....#
#....#.*...#.....#
#....###.###..*..#
#....#........*..#
#.........___....#
##################