##################
#................#
#....#######.....#
#....#.....#.....#
#....###.###.....#
#....#...........#
#................#
##################